1 1 1 1 1 1 1 1 1 1 1 1 1 1 1 1 1 Line Y=1.
1 0 0 0 0 0 0 0 1 0 0 0 0 0 0 0 1 Line Y=2.
1 0 1 0 1 0 1 0 1 0 1 1 1 1 1 0 1 Line Y=3.
1 0 0 0 0 0 0 0 1 0 1 0 0 0 0 0 1 Line Y=4.
1 0 1 0 1 0 1 0 1 0 1 0 1 1 1 1 1 Line Y=5.
1 0 0 0 0 0 0 0 0 0 1 0 0 0 0 0 1 Line Y=6.
1 1 1 1 1 1 1 1 1 1 1 1 1 1 1 0 1 Line Y=7.
0 0 0 0 0 0 0 0 0 0 0 0 0 0 0 0 1 Line Y=8.
1 1 1 1 1 1 1 1 1 1 1 1 1 1 1 1 1 Line Y=9.
9 6 Start X=9, Y=6.